-36
30
-7
35
1111111111111111111111111111111111111111111111111111111111111111111
1111111111111111111111111111111111111111111111111111111111111111111
1010000000000010011111111111111110010000000000000000000000000000011
1010000000000010000000000000000000010000000000000000000000000000011
1000000000000010000000000000000000010000000000000000000000000000011
1000000000010010000000000000000000010000000000000000000000010000011
1000000000010010000000001000000000010000000000000000000100000000011
1000000000000010000000001000000000010000000000000000000100000000011
1000000000000010000000000000000000010000000000010000000000000000011
1030110000000010000000000000000000010000000000010000000000000000011
1000110000000010000000000000000000010000000000000000001000000000011
1000000000000010000000000000000000010000000000000000000000000000011
1000000000000010000000001000000000011000100000000000000000000000011
1000000000001010000000000000000000001000000000000000000100000000011
1000000000001010000000000000000000000000000000000000000100000000011
1000000000000010000000001000000000000000000000000000000100000000011
1000010000000010000000100000000000010000000000100000000100100100011
1000000010000010000000100000000000010000000000100000000000100100011
1000000000000010000000000000000000010000000000000000000000000000011
1000000010000010000000000000000000010000000000000000000000000000011
1000000010000010000000000000000000010000000000000000000000000000011
1000000000000010000000000000000000010000000000000000001000000000011
1000000000000010000000000000000000010000000000000000000000000000011
1000000000000010000000000000000000010000010000000000000000000000011
1000000000000010000000000000000000010000010000010000000000000000011
1010000000010010000000000000000000010000000000010000000000000000011
1000010000010010000000000000000000010000000000000000000000000000011
1000010000000011111111111111111111110000000000000000000000000000011
1000000000000000000000000000000000000000000000000000000000001000011
1000000000000000000100000000000010000000000000000000000000001000011
1000000000000000000100011111111110000000111111111000000000001000011
1000010000000000000000010000000000000000000000001000000000001000011
1000010000010000000000010000000000000000000000001000000000000000011
1000000000010000100000010010000000000010000001001000000000000000011
1000000000000000100000010000000000000010000001001000000010000000011
1010000000000000100000010000000100000000000000001000000010000000011
1000000000000000000000010000000100000000010000001000000000000000011
1000001000000000000000010000000000000000000000001000000000000000011
1000001000000000100000010000000000000000000000001000000000000000011
1000000000000000100000010000000000000000000000001000000000000000011
1000000000001000000000010000000000000000000000001000000000000000011
1000000000000000000000010000000000000000000000001000000000000000011
1111111111111111111111111111111111111111111111111111111111111111111
